################
#.......#......#
#####.#.#...####
#.#...#.#...#..#
#.#.###.#.###.##
#...#.#........#
###.#.###.#.#.##
#...#.#...#...##
#.#.#.#.#.#.#.##
#.#...#.#.....##
#.##..#.#.#...##
################