################
#............#.#
#...####.###.#.#
###............#
#...####.##.##.#
#...#..........#
##.#..#..#####.#
#..#...........#
#..............#
#####.....######
#..............#
################